####################
#                  #
#     !         %  #
#                  #
#    ###           #
#    ### x         #
#           ###    #
#   x       ###    #
#                  #
#  <   ###         #
#      ###   x     #
#  x            ####
#          [   # g #
#      x       # @ #
#                  #
####################
