####################
#                  #
#               %  #
#                  #
#    ###           #
#    ###           #
#           ###    #
#           ###    #
#                  #
#      ###         #
#      ###         #
#               ####
#              #   #
#              # @ #
#                  #
####################
