&vvvvvvvvvvvvvvvvvv&
#                  =
#    $    c      % =
#             f    =
#    *^+       f   =
#    ?v/ x         =
#           *^+    =
#   x       ?v/    =
#                  =
#      *^+         =
#      ?v/   x     =
#  x           *---&
#         g    W   =
#      x         @ =
#                  =
&^^^^^^^^^^^^^^^^^^&
