####################
#                  #
#     !  g      %  #
#                  #
#    ###  x        #
#    ###           #
#           ###    #
#   x       ###  x #
#       g          #
#      ###         #
#      ###   x     #
#  x            ####
#              #   #
#      x       # @ #
#                  #
####################
