####################
#                  #
#     x            #
#                  #
#    ###   x       #
#    ###           #
#           ###    #
#           ###    #
#  x               #
#       ###        #
#       ###        #
#                  #
#               ####
#               #@ #
#                  #
####################
