&vvvvvvvvvvvvvvvvvv&
#                  =
#    $          %  =
#                  =
#    =^#           =
#    =v# x         =
#           =^#    =
#   x       =v#    =
#                  =
#      =^#         =
#      =v#   x     =
#  x           &###&
#         g    #   =
#      x         @ =
#                  =
&^^^^^^^^^^^^^^^^^^&
