####################
#                  #
#     !         %  #
#                  #
#    ###  x        #
#    ###           #
#           ###    #
#   x       ###  x #
#                  #
#      ###         #
#      ###   x     #
#  x            ####
#              #  g#
#      x       # @ #
#                 g#
####################
