&vvvvvvvvvvvvvvvvvv&
#                  =
#         c      % =
#                  =
#    *^+           =
#    ?v/ x         =
#           *^+    =
#   x       ?v/    =
#                  =
#      *^+         =
#      ?v/   x     =
#  x           *---&
#         g    W   =
#      x         @ =
#                  =
&^^^^^^^^^^^^^^^^^^&
