####################
#                  #
#     x         %  #
#                  #
#    ###   x       #
#    ###           #
#           ###    #
#           ###    #
#  x               #
#      ###         #
#      ###         #
#               ####
#              #   #
#              # @ #
#                  #
####################
