&vvvvvvvvvvvvvvvvvv&
#                  =
#    $          %  =
#                  =
#    =^#           =
#    =v# x         =
#           =##    =
#   x       =##    =
#                  =
#      =##         =
#      =##   x     =
#  x           &###&
#         g    #   =
#      x         @ =
#                  =
&^^^^^^^^^^^^^^^^^^&
