&vvvvvvvvvvvvvvvvvv&
#        %         =
#                  =
#     m            =
#                  =
#   m        x     =
#                  =
#   g  x    g      =
#              x   =
#  x             g =
#         m        =
#     m       m    =
#          g       =
#                  =
#  m        x   g @=
&^^^^^^^^^^^^^^^^^^&
