####################
#        %         #
#                  #
# x  ##########  x #
#    ##########    #
#    ##########    #
#  m            m  #
#                  #
#######      #######
#######      #######
#   x          x   #
#    x        x    #
#   #####  #####   #
# [ #    g     #   #
#   #       @  #   #
####################
