&vvvvvvvvvvvvvvvvvv&
#        %         =
#                  =
# x  *^^^^^^^^+  x =
#    =&&&&&&&&#    =
#    ?vvvvvvvv/    =
#  m            m  =
#                  =
&^^^^^+      *^^^^^&
&vvvvv/      ?vvvvv&
#   x          x   =
#    x        x    =
#   *---}  {---+   =
# [ |    g     |   =
#   |       @  |   =
&^^^&^^^^^^^^^^&^^^&
