&vvvvvvvvvvvvvvvvvv&
#             x    =
# x     m          =
#     x   *------  =
#         =%       =
#      m  =        =
#         ?--------&
&------+    m  x   =
#   x  |   x       =
#  m   W    {------&
#       m          =
# x            x   =
#   *----------}   =
#   |    x         =
# ! |  @      x    =
&^^^&^^^^^^^^^^^^^^&

