####################
#             x    #
# x     m          #
#     x    ######  #
#         #%       #
#      m  #        #
#          #########
#######     m  x   #
#   x  #   x       #
#  m   #    ########
#       m          #
# x            x   #
#    ###########   #
#   #    x         #
# @ #  @      x    #
####################

