####################
#        %         #
#                  #
#    #####         #
#         #####    #
#                  #
#  x            x  #
#                  #
#######      #######
#######      #######
#   x              #
#             x    #
#   #####  #####   #
#   #          #   #
#   #  @    @  #   #
####################

