####################
#     x       g    #
#@             x   #
################   #
#    x             #
#           x      #
#   ################
#          x       #
# x                #
################   #
#     x            #
#             x    #
#   ################
#        x       % #
#  x               #
####################

