&vvvvvv&vvv&vvvvvvv&
#      # % #       =
#      #   #  g    =
#   #  #   #@  ##  =
#   ####   #####   =
#              ##  =
#        m     #   =
#   ####   #   ## <=
#   #  #####   #  #&
#####  # m #   #   =
#    x         #  #&
#        x     #   =
#  #############  #&
#                  =
#                 g=
&^^^^^^^^^^^^^^^^^^&

