&vvvvvv&vvv&vvvvvvv&
# $    | % |       =
#      |   |  g    =
#   A  |   |@  *}  =
#   ?--/   ?---#   =
#              =}  =
#        m     |   =
#   *--+   A   =} <=
#   |  =---#   |  {&
&---/  W m W   |   =
#    x         |  {&
#        x     |   =
#  {-----------/  {&
#                  =
#                 g=
&^^^^^^^^^^^^^^^^^^&

