####################
#      # % #       #
#      #   #  g    #
#   #  #   #@  ##  #
#   ####   #####  ##
#              ##  #
#        m     #  ##
#   ####   #   ## <#
#   #  #####   #  ##
#####  # m #   ##  #
#    x         #  ##
#        x     ##  #
#  #############  ##
#                  #
#                 g#
####################

