####################
#        %         #
#                  #
#     m            #
#                  #
#   m        x     #
#                  #
#      x           #
#              x   #
#  x               #
#         m        #
#     m       m    #
#                  #
#                  #
#  m        x      #
####################

