&&vvvvvvvvvvvvvvvvv&
&% &  <            =
#  v               =
#     *---------}  =
#     |            =
&^^^^^/            =
&vvvv#   ----------&
#    |  |  g       =
#  < |  |          =
#  {-/  ?---}  A   =
#  g           |   =
#              |   =
&}  {}  *------/   =
#       |  g    g  =
#  g    #@         =
&^^^^^^^&^^^^^^^^^^&
