&vvvvvvvvvvvvvvvvvv&
#% &  <            =
#  v               =
#     ^&&&&&&&&&#  =
#     &            =
&^^^^^#            =
&vvvv#   &&&&&&&&&&&
#    #  #  g       =
#  < #  #          =
#  ###  #####  #   =
#  g           #   =
#              #   =
&#  ##  ########   =
#       #  g    g  =
#  g    #@         =
&^^^^^^^&^^^^^^^^^^&
