####################
#% #  <            #
#  #               #
#     ###########  #
#     #            #
#######  ###########
######   # g       #
#    #  #          #
#  < #  #      #   #
#  ###  #####  #   #
#  g           #   #
#              #   #
##  ##  ########   #
#       #  g    g  #
#  g    #@         #
>>>>>>> origin/master
####################
