&vvvvvvvvvvvvvvvvvv&
#   g     g        =
#g     g           =
#  ^^^^^^^^^ m ^   =
#  =       #   &   =
#  =       #  g& x =
#  =&    &v#   &   =
#%  =    #     & x =
#   =    #  m  &   =
#   =    #     & x =
#   =    #  g  &   =
#   vvvvvv     & x =
#  x  <   x m  &   =
#     x     !  & @ =
#         g    &   =
#^^^^^^^^^^^^^^#^^^&

