####################
#   g     g        #
#g     g           #
#  ######### m #   #
#  #########   #   #
#  #########  g# x #
#  #########   #   #
#%  ######     # x #
#   ######  m  #   #
#   ######     # x #
#   ######  g  #   #
#   ######     # x #
#  x  <   x m  #   #
#     x        # @ #
####################

