&vvvvvvvvvvvvvvvvvv&
#   g     g        =
#g     g           =
#  *-------+ m A   =
#  =       #   |   =
#  =       #  g| x =
#  ?+    *v/   |   =
#%  |    |     | x =
#   |    |  m  |   =
#   |    |     | x =
#   |    |  g  |   =
#   ?vvvv/     | x =
#  x  <   x m  |   =
#     x     !  | @ =
#         g    |   =
&^^^^^^^^^^^^^^&^^^&

