&vvvvvvvvvvvvvvvvvv&
#  g      m        =
#     [        m   =
#     ^^^^^^^^     =
#  g  =&&&&&&#   m =
#     =&&&&&&#     =
# xx  =&&&&&&#     =
#     =&&&&&&#  xx =
#     =&&&&&&#     =
# xx  =&&&&&&#     =
#     =&&&&&&#  xx =
#     =&&&&&&#     =
# xx  =&&&&&&#     =
#     =&&&&&&#  xx =
#  %  =&&&&&&#  @  =
&^^^^^^^^^^^^^^^^^^&
