&vvvvvvvvvvvvvvvvvv&
# %    v           =
#        x    m    =
#                  =
&&&&&&&&&&&&#   x  =
#                  =
#  m     x    x    =
#                  =
#    =&&&&&&&&&&&&&&
#     &            =
#  x  &  g      x  =
#     &      ^     =
#     v      &  x  =
#  m     g   &     =
#            &  @  =
&^^^^^^^^^^^^^^^^^^&
