####################
# %    #           #
#        x    m    #
#                  #
#############   x  #
#                  #
#  m     x    x    #
#                  #
#    ###############
#     #            #
#  x  #  g      x  #
#     #      #     #
#     #      #  x  #
#  m     g   #     #
#            #  @  #
####################
